000000000000000000
000000000000000000
000000011111000000
000000199999155000
000000011119955000
000000000005991000
000000000055599100
000000000555019100
000000005550019100
000000055500019100
000000555000019100
000005550000001000
000055500000000000
000555000000000000
000550000000000000
000000000000000000
000000000000000000
000000000000000000