000000000000000000
000000111111000000
000011222222110000
000102200002201000
001222000000200100
001220030030022100
012230330033032210
010230330033032210
010030000000032210
010022002200222010
010222222222220010
012221111111122010
001110100001011100
000100010010001000
000100000000001000
000010000000010000
000001111111100000
000000000000000000